一二三四五六七八九零一二三四五六七八九零
二○○○○○○○○○○○○○○○○○○一
三○○○○○○○○○○○○○○○○○○二
四○○○○○○○○○○○○○○○○○○三
五○○○○○○○○○○○○○○○○○○四
六○○○○○○○○○○○○○○○○○○五
七○○○○○○○○○○○○○○○○○○六
八○○○○○○○○○○○○○○○○○○七
九○○○○○○○○○○○○○○○○○○八
零○○○○○○○○○○○○○○○○○○九
一○○○○○○○○○○○○○○○○○○零
二○○○○○○○○○○○○○○○○○○一
三○○○○○○○○○○○○○○○○○○二
四○○○○○○○○○○○○○○○○○○三
五○○○○○○○○○○○○○○○○○○四
六○○○○○○○○○○○○○○○○○○五
七○○○○○○○○○○○○○○○○○○六
八○○○○○○○○○○○○○○○○○○七
九○○○○○○○○○○○○○○○○○○八
零一二三四五六七八九零一二三四五六七八九